#                             ##
#                             ##
#                             ##
#                             ##
#                             ##
#                             ##
#       #####     ###         ##
#        ##########           ##
#                             ##
#                             ##
#                             ##
#                             ##
#                             ##
#                             ##
#                             ##
#                             ##
#                             ##
#                             ##
#               ##  o   ###   ##
#                #########    ##
#                   ###       ##
#                              #
#                              #
#                              #
