#                              #
#                              #
#                              #
#                             ##
#                             ##
#                             ##
#       #############         ##
#          #######            ##
#                             ##
#                             ##
#                             ##
#                             ##
#                             ##
#                             ##
#                             ##
#                             ##
#                             ##
#                             ##
#               ###########   ##
#                #########    ##
#                             ##
#                              #
#                              #
#                              #
