#                              #
#                              #
#                              #
#                             ##
#                             ##
#        ##                   ##
#       #####     ###         ##
#        ##########           ##
#                             ##
#                             ##
#                             ##
#                             ##
#                             ##
#                             ##
#                             ##
#                             ##
#                             ##
#                             ##
#               ##      ###   ##
#                #########    ##
#                   ###       ##
#                              #
#                              #
#                              #
