#                            ###
#                             ##
#                              #
##                             #
##                   #######   #
##                      #      #
##                             #
##                             #
##                             #
##                             #
##                             #
##                             #
##                             #
##                             #
##                             #
##                             #
##                             #
##                             #
##         o                   #
##      ########               #
##        ####                 #
#                              #
#                              #
#                              #
