################################
#                              #
#                              #
#                              #
#                              #
#                              #
#                              #
#                              #
                               #
                               #
                               #
                               #
                               #
#                              #
#                              #
#                              #
#                              #
#                              #
#                              #
#                              #
#                              #
#                              #
#                              #  
################################