#                              #
#                              #
#                              #
#                              #
#                              #
#            #############     #
#                #####         #
#                              #
#########                      #
######                         #
###                            #
###                            #
###                            #
##                             #
##                             #
##                             #
#                              #
#                              #
#                              #
#                              #
#                              #
#               #########      #
#                 #####        #
#                              #
