#                              #
#                              #
#                              #
#                          #####
#                            ###
#                             ##
#                              #
#                              #
#                              #
#                              #
#              #########       #
#                 ###          #
#                              #
#                              #
#                              #
#                              #
########                       #
#####                          #
##                             #
#                              #
#                              #
#                              #
#                              #
#            #############     #
