#                ######        #
#                              #
#                              #
#                              #
#                              #
#                              #
#                              #
#       ##########             #
#          #####               #
#                              #
#                              #
#                              #
#                              #
#                     #######  #
#                       ###    #
#########                      #
######                         #
#####                          #
###                            #
###                            #
##                             #
##                             #
##                             #
#    ########                  #
