#                              #
#                              #
#                              #
#                              #
#                              #
#     #####                    #
#   ########                   #
#       ###                    #
#                              #
#                              #
#                              #
#                              #
#                              #
#                              #
#               ##########     #
#              ########        #
#                              #
#                              #
#                              #
#                              #
#              ##              #
#       #########              #
#          ###                 #
#                          #####
