#                              #
#                              #
#                              #
#                              #
#                              #
#       #####                  #
#     ########                 #
#         ###                  #
#                              #
#                              #
#                              #
#                              #
#                              #
#                              #
#                ##########    #
#               ########       #
#                              #
#                              #
#                              #
#                              #
#              ##              #
#       #########              #
#          ###                 #
#                          #####
