#                              #
#                              #
#                              #
#                              #
#                              #
#       #####                  #
#         #                    #
#                              #
#                              #
#                              #
#                              #
#                              #
#                              #
#                              #
#                ##########    #
#                   ####       #
#                              #
#                              #
#                              #
#                              #
#                              #
#       #########              #
#          ###                 #
#                          #####
