#                              #
             ############      #
                 ####          #
                               #
    ###############            #
        #######                #
                      ######   #
                        ###    #
                               #
                               #
  ###########                  #
      ####                     #
                               #
                               #
                   #############
                        ########
                             ###
#####                        ###
###                           ##
                              ##
                              ##
                             ###
                            ####
################################
