#                              #
           ##############      #
               ######          #
                               #
                               #
                         ###   #
                      ######   #
                       ###     #
                               #
  ####                         #
  ###########                  #
      ####                     #
                               #
                               #
                   #############
                        ########
                             ###
#####                        ###
###                           ##
##                            ##
                              ##
                             ###
                            ####
################################
