#                              #
#                              #
#                              #
#                              #
#                              #
#                              #
#                              #
#                              #
#                              #
#                              #
#                              #
#         ###########          #
#            ######            #
#                              #
#                              #
#                              #
#                              #
#                          #####
#                            ###
#                            ###
#                             ##
#                             ##
#                              #
#                              #
