#                              #
#                              #
#    ###########               #
#      #######                 #
#                              #
#                              #
#                              #
#                              #
#                              #
#                              #
#                              #
#                              #
#                              #
#                              #
#                              #
#                              #
#                              #
#                          #####
#                            ###
#                            ###
#                             ##
#                             ##
#                              #
#                              #
