#                              #
#                              #
#                              #
#                              #
#                              #
#                              #
#                              #
#        #################     #
#             ########         #
#                              #
#                              #
#                              #
#                              #
#                              #
#                              #
#                              #
#                              #
#                        #######
#                          #####
#                          #####
#                            ###
#                             ##
#                             ##
#                              #
