#                             ##
#                             ##
#                              #
#                              #
#                              #
#          ###########         #
#            ######            #
#                              #
#                              #
#                              #
#                              #
#                              #
#                              #
#                              #
#   #####                      #
#     #                        #
#                              #
#                             ##
#                            ###
#                     ##########
#                          #####
#                            ###
#                           ####
################################
