#                             ##
#                             ##
#                              #
#                              #
#                              #
#          ###########         #
#            ######            #
#                              #
#                              #
#                              #
#                              #
#                              #
#                              #
#                              #
#   #####                      #
#     #                        #
#                              #
#                              #
#                     #######  #
#                       ###    #
#                              #
#                              #
#                              #
################################
