#                              #
#                              #
#                              #
#                              #
#                              #
#                              #
#                              #
#                              #
#                              #
#                              #
#                              #
#                              #
#                           ####
#                            ###
#                             ##
#                             ##
#                             ##
#                              #
#                              #
##########                     #
######                         #
###                            #
###                            #
#                              #
