#                              #
#                              #
#                              #
#                              #
#                              #
#             #######          #
#               ###            #
#                              #
#                              #
#                              #
#                              #
#    ########                  #
#      ####                    #
#                              #
#                              #
#                              #
#                              #
#                              #
#                              #
#                              #
#                              #
#                   ########   #
#                      ###     #
#                              #
