#                              #
#                              #
#                              #
#                              #
#                              #
#             #######          #
#               ###            #
#                              #
#                              #
#                              #
#                              #
#                              #
#     ########                 #
#       ####                   #
#                              #
#                              #
#                              #
#                              #
#                              #
#                              #
#                              #
#                   ########   #
#                      ###     #
#                              #
