#                              #
#                              #
#                              #
#                              #
#                              #
#                #######       #
#                  ###         #
#                              #
#                              #
#                              #
#                              #
#                              #
#     ########                 #
#       ####                   #
#                              #
#                              #
#                              #
#                              #
#                              #
#                              #
#                              #
#                   ########   #
#                      ###     #
#                              #
