#                              #
#    ##########                #
#       ####                   #
#                              #
#                              #
#                              #
#                              #
#                              #
#         #####                #
#           #                  #
#                              #
#                              #
#                              #
#                           ####
#                             ##
####                           #
##                             #
#                              #
#                              #
#                              #
#                              #
#                              #
#                              #
#########                      #
