################################
#####                ###########
###                      #######
#                           ####
#                              #
#                              #
#                              #
####                           #
#######                       ##
################              ##
####################          ##
#    #############             #
#                              #
#                              #
#                              #
#                             ##
#                       ########
#                    ###########
#                    ###########
##                    ####     #
##                             #
###                            #
#####                          #
################################
