################################
#                              #
#                              #
#                              #
#                              #
#                              #
#                              #
#                              #
#                              #
#   #                          #
#   #                          #
#   #                          #
#   #                          #
#   #                          #
#   #                          #
#   #                          #
#   #                          #
#   #                          #
#   #                          #
#   #                          #
#   #                          #
#   #                          #
#   #                          #
################################
