################################
#                              #
#                              #
#                              #
#                              #
#                              #
#                              #
#                              #
#                              #
#                              #
#                              #
#                  #####       #
#                              #
#                              #
#                              #
#      #                       #
#      ##                      #
#      ###                     #
#                     #        #
#                    ##        #
#                   ###        #
#                              #
#                              #
#                         #    #
##     #                  #   ##
################################
